1539551153
878697C6BA
AFAFAFFFAA
AFEF857F86
AFFFAFFFC3
853FAFD516
AD6FAFFF83
8155055542
AC3BC5393A
C54457C6C4

0,0
9,9
SSSSSSSEEEEEEEEESS
